.##########
....#...#.#
###.#.#.#.#
#.#...#.#.#
#.#####.#.#
#.....#...#
#.#.#####.#
#.#.#.....#
#.#.#.#####
#.#........
##########.
