.####################
..#.....#...........#
#.###.#.#.###.#####.#
#.....#.#...#.#.....#
#######.#####.#####.#
#.....#.....#.....#.#
#.#.#######.#####.#.#
#.#.......#...#...#.#
#.#####.#.###.#.#####
#.#...#.#.#...#.....#
#.#.###.###.###.###.#
#.#...#...#...#...#.#
#.###.###.###.###.#.#
#.....#.....#...#.#.#
###.###.#######.###.#
#.#.#...#.....#...#.#
#.#.#.###.#.#####.#.#
#...#...#.#...#...#.#
#.#####.#.###.#.###.#
#.....#.....#........
####################.
