o##########
oo#.......#
#o#.###.#.#
#o#...#.#.#
#o###.#.###
#ooo#.#...#
###o#####.#
#.#ooooooo#
#.#######o#
#........oo
##########o
