o####################
oooooo#........ooooo#
#####o#####.###o###o#
#.#ooo#ooo#.#ooo#ooo#
#.#o###o#o###o###o###
#ooo#ooo#ooooo#.#ooo#
#o###o#########.###o#
#ooo#ooooooo#..ooooo#
###o#.#####o###o#####
#ooo#.#ooo#ooo#o#...#
#o#####o#o###o#o###.#
#ooooooo#ooooo#ooooo#
###################o#
#.................#o#
#.###############.#o#
#...#.......#.....#o#
###.#.#####.#######o#
#...#.....#.#.....#o#
#.#######.#.#.###.#o#
#.........#.....#..oo
####################o
